41
41
0
22
+++++++++++++++++++++S+++++++++++++++++++
+OOO+OOOOO+OOOOOOO+OOOOOOO+OOOOOOOOO+OOO+
+O+O+O+++O+O+++++O+O+++++O+O+++++++O+O+O+
+O+OOO+OOO+OOO+OOO+OOO+O+OOOOOOO+OOO+O+O+
+O+++++O+++++O+O+++++O+O+++++++++O+++O+O+
+O+OOOOOOO+OOO+OOOOO+OOOOO+OOOOO+OOOOO+O+
+O+++++++++O+++++O+O+++++O+O+++O+O+++++O+
+OOOOOOOOO+O+O+OOO+O+OOOOO+OOO+O+O+OOO+O+
+O+++++++O+O+O+O+++++O+++++++O+O+++O+O+O+
+OOO+OOO+OOO+O+OOOOOOO+OOO+OOO+OOOOO+OOO+
+++O+O+O+++++O+++++++++O+++O+++++++++++O+
+O+O+O+OOOOOOOOO+OOOOO+O+OOO+OOO+OOO+OOO+
+O+O+O+++O+++++O+++O+O+O+O+++O+O+O+O+++O+
+OOO+OOO+O+OOO+OOO+O+OOO+OOOOO+OOO+OOO+O+
+O+++++O+O+O+O+++O+O+++O+++++++++++++O+O+
+OOO+OOO+O+O+OOOOOOO+OOOOOOO+OOOOOOOOO+O+
+++O+O+++O+O+++++++++++++++++O+++++++++O+
+O+O+OOO+O+OOO+OOOOOOOOOOOOO+O+OOOOOOOOO+
+O+O+++++O+++O+O+++++++++++O+O+++++++O+++
+OOOOOOO+OOO+O+OOO+OOOOOOO+O+OOOOOOO+OOO+
+++++++O+++O+++++O+O+++++O+O+O+++++O+++O+
+O+OOO+O+OOO+OOOOO+OOOOO+O+O+OOO+O+O+OOO+
+O+++O+O+O+O+O+++++++++O+++O+++O+O+O+++O+
+OOO+OOOOO+O+O+OOO+OOO+OOO+O+OOOOO+OOO+O+
+++O+++++++++O+O+O+O+O+++O+O+++++O+++O+O+
+O+OOO+OOOOOOO+O+O+O+OOOOO+OOO+O+OOO+O+O+
+O+++O+O+++++++O+O+O+++++O+++O+O+++O+O+++
+OOO+OOO+OOOOOOO+OOO+OOOOO+OOO+OOO+O+OOO+
+O+O+++++O+O+++++O+++++++O+O+++O+O+O+++O+
+O+OOOOO+O+O+OOOOO+OOOOO+O+O+OOO+OOOOO+O+
+O+++++O+O+O+++++++O+++O+O+O+++++++++++O+
+O+O+OOO+O+OOOOOOOOO+OOO+O+OOOOOOO+OOO+O+
+O+O+O+++O+++++++++++O+++O+++++++O+O+O+O+
+OOO+OOO+OOO+OOOOOOO+O+OOOOOOOOO+O+O+O+O+
+++O+++O+++O+O+O+++O+O+++O+++++++O+O+O+O+
+O+O+O+OOOOO+O+OOO+O+OOO+O+OOOOOOO+O+OOO+
+O+O+O+++++++++++O+++++O+++O+++++++O+++O+
+OOO+OOOOO+OOOOO+OOO+OOO+OOO+OOO+OOO+O+O+
+O+++O+++O+O+++O+++O+O+++O+++O+O+O+++O+O+
+OOOOO+OOOOO+OOOOOOO+OOOOOOOOO+OOO+OOOOO+
+++++++++++++++++++++E+++++++++++++++++++